# This is an exemplary layout file.

# Format is following:
# - there are exactly 15 rows
# - each row consists of 36 cells, separated by ^ character
# - each cell consists of 2 chars, first being the source payload
#   and second being the target payload
# - Character "~" is used to represent "No payload"

# Example #1, cell defined as "WR" mean:
# - I will start with the letter W
# - I will expect the carrier to take the W out and bring the R letter in

# Example #2, cell defined as "W~" mean:
# - I will start with the letter W
# - I will expect carriers not to bring anything

# Example #3, cell defined as "~W" mean:
# - I will start empty
# - I will expect carriers to bring letter W

# As you probably noticed, empty lines and lines beginning with '#' are ignored

~W^~A^~R^~S^~Z^~A^~W^~A^~~^~C^~E^~N^~T^~R^~A^~L^~N^~A^~~^~~^~~^~~^~~^~~^~~^~~^~~^~~^~~^~~^~~^~1^~1^~:^~3^~4
WŁ^AÓ^RD^SŹ^Z~^AK^WA^AL^~I^CS^EK^NA^T~^R~^A~^L~^N~^A~^~~^~~^~~^~~^~~^~~^~~^~~^~~^~~^~~^~~^~~^11^11^::^35^46
Ł~^Ó~^D~^Ź~^~~^K~^A~^L~^I~^S~^K~^A~^~~^~~^~~^~~^~~^~~^~~^~~^~~^~~^~~^~~^~~^~~^~~^~~^~~^~~^~~^1~^1~^:~^5~^6~
~~^~~^~~^~~^~~^~~^~~^~~^~~^~~^~~^~~^~~^~~^~~^~~^~~^~~^~~^~~^~~^~~^~~^~~^~~^~~^~~^~~^~~^~~^~~^~~^~~^~~^~~^~~
~~^~~^~~^~~^~~^~~^~~^~~^~~^~~^~~^~~^~~^~~^~~^~~^~~^~~^~~^~~^~~^~~^~~^~~^~~^~~^~~^~~^~~^~~^~~^~~^~~^~~^~~^~~
~~^~~^~~^~~^~~^~~^~~^~~^~~^~~^~~^~~^~~^~~^~~^~~^~~^~~^~~^~~^~~^~~^~~^~~^~~^~~^~~^~~^~~^~~^~~^~~^~~^~~^~~^~~
~~^~~^~~^~~^~~^~~^~~^~~^~~^~~^~~^~~^~~^~~^~~^~~^~~^~~^~~^~~^~~^~~^~~^~~^~~^~~^~~^~~^~~^~~^~~^~~^~~^~~^~~^~~
~~^~~^~~^~~^~~^~~^~~^~~^~~^~~^~~^~~^~~^~~^~~^~~^~~^~~^~~^~~^~~^~~^~~^~~^~~^~~^~~^~~^~~^~~^~~^~~^~~^~~^~~^~~
~~^~~^~~^~~^~~^~~^~~^~~^~~^~~^~~^~~^~~^~~^~~^~~^~~^~~^~~^~~^~~^~~^~~^~~^~~^~~^~~^~~^~~^~~^~~^~~^~~^~~^~~^~~
~~^~~^~~^~~^~~^~~^~~^~~^~~^~~^~~^~~^~~^~~^~~^~~^~~^~~^~~^~~^~~^~~^~~^~~^~~^~~^~~^~~^~~^~~^~~^~~^~~^~~^~~^~~
~~^~~^~~^~~^~~^~~^~~^~~^~~^~~^~~^~~^~~^~~^~~^~~^~~^~~^~~^~~^~~^~~^~~^~~^~~^~~^~~^~~^~~^~~^~~^~~^~~^~~^~~^~~
~~^~~^~~^~~^~~^~~^~~^~~^~~^~~^~~^~~^~~^~~^~~^~~^~~^~~^~~^~~^~~^~~^~~^~~^~~^~~^~~^~~^~~^~~^~~^~~^~~^~~^~~^~~
~~^~~^~~^~~^~~^~~^~~^~~^~~^~~^~~^~~^~~^~~^~~^~~^~~^~~^~~^~~^~~^~~^~~^~~^~~^~~^~~^~~^~~^~~^~~^~~^~~^~~^~~^~~
~~^~~^~~^~~^~~^~~^~~^~~^~~^~~^~~^~~^~~^~~^~~^~~^~~^~~^~~^~~^~~^~~^~~^~~^~~^~~^~~^~~^~~^~~^~~^~~^~~^~~^~~^~~
~~^~~^~~^~~^~~^~~^~~^~~^~~^~~^~~^~~^~~^~~^~~^~~^~~^~~^~~^~~^~~^~~^~~^~~^~~^~~^~~^~~^~~^~~^~~^~~^~~^~~^~~^~~

